DATE,LA21_NAME,LA21_CD,PROVIDES_NO_UNPAID_CARE,PROVIDES_19_OR_LESS_HOURS_UNPAID_CARE_A_WEEK,PROVIDES_20_TO_49_HOURS_UNPAID_CARE_A_WEEK,PROVIDES_50_OR_MORE_HOURS_UNPAID_CARE_A_WEEK,TOTAL_PROVIDING,TOTAL_SOUTH_ASIAN_POPULATION ,PERCENTAGE_OF_SOUTH_ASIAN_POPULATION,INDEX,PROVIDES_19_OR_LESS_HOURS_UNPAID_CARE_A_WEEK_PROP,PROVIDES_20_TO_49_HOURS_UNPAID_CARE_A_WEEK_PROP,PROVIDES_50_OR_MORE_HOURS_UNPAID_CARE_A_WEEK_PROP
2021,Hartlepool,E06000001,177,6,2,16,24,201,12%,1.01,2.99%,1.00%,7.96%
2021,Merthyr Tydfil,W06000024,68,4,0,7,11,79,14%,1.18,5.06%,0.00%,8.86%
2021,Powys,W06000023,120,7,3,4,14,134,10%,0.89,5.22%,2.24%,2.99%
2021,Newport,W06000022,1443,59,49,84,192,1635,12%,1,3.61%,3.00%,5.14%
2021,Monmouthshire,W06000021,89,8,0,1,9,98,9%,0.78,8.16%,0.00%,1.02%
2021,Torfaen,W06000020,122,7,5,2,14,136,10%,0.87,5.15%,3.68%,1.47%
2021,Blaenau Gwent,W06000019,86,4,2,5,11,97,11%,0.96,4.12%,2.06%,5.15%
2021,Caerphilly,W06000018,212,6,3,14,23,235,10%,0.83,2.55%,1.28%,5.96%
2021,Rhondda Cynon Taf,W06000016,346,22,8,17,47,393,12%,1.02,5.60%,2.04%,4.33%
2021,Cardiff,W06000015,4101,144,147,198,489,4590,11%,0.9,3.14%,3.20%,4.31%
2021,Vale of Glamorgan,W06000014,285,18,10,10,38,323,12%,1,5.57%,3.10%,3.10%
2021,Bridgend,W06000013,233,11,6,15,32,265,12%,1.03,4.15%,2.26%,5.66%
2021,Neath Port Talbot,W06000012,240,12,12,9,33,273,12%,1.03,4.40%,4.40%,3.30%
2021,Swansea,W06000011,1217,59,35,49,143,1360,11%,0.89,4.34%,2.57%,3.60%
2021,Carmarthenshire,W06000010,205,11,8,15,34,239,14%,1.21,4.60%,3.35%,6.28%
2021,Pembrokeshire,W06000009,100,4,3,4,11,111,10%,0.84,3.60%,2.70%,3.60%
2021,Ceredigion,W06000008,92,6,3,3,12,104,12%,0.98,5.77%,2.88%,2.88%
2021,Wrexham,W06000006,230,8,13,5,26,256,10%,0.86,3.13%,5.08%,1.95%
2021,Flintshire,W06000005,151,5,5,5,15,166,9%,0.77,3.01%,3.01%,3.01%
2021,Denbighshire,W06000004,147,4,5,6,15,162,9%,0.79,2.47%,3.09%,3.70%
2021,Conwy,W06000003,176,4,6,9,19,195,10%,0.83,2.05%,3.08%,4.62%
2021,Gwynedd,W06000002,152,3,7,2,12,164,7%,0.62,1.83%,4.27%,1.22%
2021,Isle of Anglesey,W06000001,55,2,2,2,6,61,10%,0.84,3.28%,3.28%,3.28%
2021,Somerset,E06000066,587,20,21,30,71,658,11%,0.92,3.04%,3.19%,4.56%
2021,Tewkesbury,E07000083,150,6,7,7,20,170,12%,1,3.53%,4.12%,4.12%
2021,Stroud,E07000082,111,6,3,0,9,120,8%,0.64,5.00%,2.50%,0.00%
2021,Gloucester,E07000081,931,42,32,43,117,1048,11%,0.95,4.01%,3.05%,4.10%
2021,Forest of Dean,E07000080,84,0,2,2,4,88,5%,0.39,0.00%,2.27%,2.27%
2021,Cotswold,E07000079,72,7,4,1,12,84,14%,1.21,8.33%,4.76%,1.19%
2021,Cheltenham,E07000078,472,28,8,10,46,518,9%,0.75,5.41%,1.54%,1.93%
2021,West Devon,E07000047,38,0,3,3,6,44,14%,1.16,0.00%,6.82%,6.82%
2021,Torridge,E07000046,35,3,1,0,4,39,10%,0.87,7.69%,2.56%,0.00%
2021,Teignbridge,E07000045,99,2,1,2,5,104,5%,0.41,1.92%,0.96%,1.92%
2021,South Hams,E07000044,63,1,1,5,7,70,10%,0.85,1.43%,1.43%,7.14%
2021,North Devon,E07000043,69,2,3,6,11,80,14%,1.17,2.50%,3.75%,7.50%
2021,Mid Devon,E07000042,52,3,0,2,5,57,9%,0.74,5.26%,0.00%,3.51%
2021,Exeter,E07000041,430,14,13,12,39,469,8%,0.71,2.99%,2.77%,2.56%
2021,East Devon,E07000040,118,5,4,9,18,136,13%,1.12,3.68%,2.94%,6.62%
2021,Dorset,E06000059,378,9,9,17,35,413,8%,0.72,2.18%,2.18%,4.12%
2021,"Bournemouth, Christchurch and Poole",E06000058,1176,41,29,37,107,1283,8%,0.71,3.20%,2.26%,2.88%
2021,Wiltshire,E06000054,877,28,17,30,75,952,8%,0.67,2.94%,1.79%,3.15%
2021,Isles of Scilly,E06000053,0,0,0,0,0,0,0%,0,0.00%,0.00%,0.00%
2021,Cornwall,E06000052,395,20,13,12,45,440,10%,0.87,4.55%,2.95%,2.73%
2021,Swindon,E06000030,2308,74,40,78,192,2500,8%,0.65,2.96%,1.60%,3.12%
2021,Torbay,E06000027,217,6,16,9,31,248,13%,1.06,2.42%,6.45%,3.63%
2021,Plymouth,E06000026,590,13,18,22,53,643,8%,0.7,2.02%,2.80%,3.42%
2021,South Gloucestershire,E06000025,913,54,26,41,121,1034,12%,0.99,5.22%,2.51%,3.97%
2021,North Somerset,E06000024,331,13,12,7,32,363,9%,0.75,3.58%,3.31%,1.93%
2021,"Bristol, City of",E06000023,3689,182,122,177,481,4170,12%,0.98,4.36%,2.93%,4.24%
2021,Bath and North East Somerset,E06000022,476,18,15,8,41,517,8%,0.67,3.48%,2.90%,1.55%
2021,Worthing,E07000229,392,20,7,17,44,436,10%,0.86,4.59%,1.61%,3.90%
2021,Mid Sussex,E07000228,415,22,16,10,48,463,10%,0.88,4.75%,3.46%,2.16%
2021,Horsham,E07000227,323,12,11,17,40,363,11%,0.94,3.31%,3.03%,4.68%
2021,Crawley,E07000226,2083,109,79,108,296,2379,12%,1.06,4.58%,3.32%,4.54%
2021,Chichester,E07000225,184,13,8,11,32,216,15%,1.26,6.02%,3.70%,5.09%
2021,Arun,E07000224,290,15,4,19,38,328,12%,0.98,4.57%,1.22%,5.79%
2021,Adur,E07000223,162,9,4,9,22,184,12%,1.02,4.89%,2.17%,4.89%
2021,Woking,E07000217,1484,79,67,74,220,1704,13%,1.1,4.64%,3.93%,4.34%
2021,Waverley,E07000216,315,25,8,16,49,364,13%,1.14,6.87%,2.20%,4.40%
2021,Tandridge,E07000215,276,17,6,6,29,305,10%,0.81,5.57%,1.97%,1.97%
2021,Surrey Heath,E07000214,741,28,23,16,67,808,8%,0.7,3.47%,2.85%,1.98%
2021,Spelthorne,E07000213,1253,56,31,55,142,1395,10%,0.86,4.01%,2.22%,3.94%
2021,Runnymede,E07000212,624,31,12,22,65,689,9%,0.8,4.50%,1.74%,3.19%
2021,Reigate and Banstead,E07000211,922,36,26,51,113,1035,11%,0.93,3.48%,2.51%,4.93%
2021,Mole Valley,E07000210,280,8,5,12,25,305,8%,0.7,2.62%,1.64%,3.93%
2021,Guildford,E07000209,640,31,15,18,64,704,9%,0.77,4.40%,2.13%,2.56%
2021,Epsom and Ewell,E07000208,880,54,30,32,116,996,12%,0.99,5.42%,3.01%,3.21%
2021,Elmbridge,E07000207,787,43,19,26,88,875,10%,0.85,4.91%,2.17%,2.97%
2021,West Oxfordshire,E07000181,176,4,3,9,16,192,8%,0.71,2.08%,1.56%,4.69%
2021,Vale of White Horse,E07000180,382,17,19,13,49,431,11%,0.97,3.94%,4.41%,3.02%
2021,South Oxfordshire,E07000179,349,18,12,12,42,391,11%,0.91,4.60%,3.07%,3.07%
2021,Oxford,E07000178,2310,100,81,103,284,2594,11%,0.93,3.86%,3.12%,3.97%
2021,Cherwell,E07000177,891,32,26,30,88,979,9%,0.76,3.27%,2.66%,3.06%
2021,Tunbridge Wells,E07000116,390,15,13,11,39,429,9%,0.77,3.50%,3.03%,2.56%
2021,Tonbridge and Malling,E07000115,329,15,12,14,41,370,11%,0.94,4.05%,3.24%,3.78%
2021,Thanet,E07000114,351,12,11,13,36,387,9%,0.79,3.10%,2.84%,3.36%
2021,Swale,E07000113,285,12,11,12,35,320,11%,0.93,3.75%,3.44%,3.75%
2021,Folkestone and Hythe,E07000112,411,11,12,21,44,455,10%,0.82,2.42%,2.64%,4.62%
2021,Sevenoaks,E07000111,295,8,6,19,33,328,10%,0.85,2.44%,1.83%,5.79%
2021,Maidstone,E07000110,766,20,18,31,69,835,8%,0.7,2.40%,2.16%,3.71%
2021,Gravesham,E07000109,1533,88,49,84,221,1754,13%,1.07,5.02%,2.79%,4.79%
2021,Dover,E07000108,193,4,2,8,14,207,7%,0.57,1.93%,0.97%,3.86%
2021,Dartford,E07000107,984,52,18,35,105,1089,10%,0.82,4.78%,1.65%,3.21%
2021,Canterbury,E07000106,556,16,15,14,45,601,7%,0.64,2.66%,2.50%,2.33%
2021,Ashford,E07000105,751,26,20,40,86,837,10%,0.87,3.11%,2.39%,4.78%
2021,Winchester,E07000094,308,16,5,13,34,342,10%,0.84,4.68%,1.46%,3.80%
2021,Test Valley,E07000093,304,14,7,17,38,342,11%,0.94,4.09%,2.05%,4.97%
2021,Rushmoor,E07000092,1784,39,42,82,163,1947,8%,0.71,2.00%,2.16%,4.21%
2021,New Forest,E07000091,248,6,3,5,14,262,5%,0.45,2.29%,1.15%,1.91%
2021,Havant,E07000090,195,7,3,10,20,215,9%,0.79,3.26%,1.40%,4.65%
2021,Hart,E07000089,291,19,6,4,29,320,9%,0.77,5.94%,1.88%,1.25%
2021,Gosport,E07000088,125,5,2,3,10,135,7%,0.63,3.70%,1.48%,2.22%
2021,Fareham,E07000087,198,8,10,3,21,219,10%,0.81,3.65%,4.57%,1.37%
2021,Eastleigh,E07000086,491,21,13,20,54,545,10%,0.84,3.85%,2.39%,3.67%
2021,East Hampshire,E07000085,204,6,8,8,22,226,10%,0.83,2.65%,3.54%,3.54%
2021,Basingstoke and Deane,E07000084,847,42,18,36,96,943,10%,0.86,4.45%,1.91%,3.82%
2021,Wealden,E07000065,232,18,5,6,29,261,11%,0.94,6.90%,1.92%,2.30%
2021,Rother,E07000064,151,9,3,8,20,171,12%,0.99,5.26%,1.75%,4.68%
2021,Lewes,E07000063,228,14,10,10,34,262,13%,1.1,5.34%,3.82%,3.82%
2021,Hastings,E07000062,244,12,15,12,39,283,14%,1.17,4.24%,5.30%,4.24%
2021,Eastbourne,E07000061,411,19,15,24,58,469,12%,1.05,4.05%,3.20%,5.12%
2021,Buckinghamshire,E06000060,6652,337,226,293,856,7508,11%,0.97,4.49%,3.01%,3.90%
2021,Isle of Wight,E06000046,169,11,3,10,24,193,12%,1.06,5.70%,1.55%,5.18%
2021,Southampton,E06000045,2568,77,73,119,269,2837,9%,0.81,2.71%,2.57%,4.19%
2021,Portsmouth,E06000044,1549,71,38,70,179,1728,10%,0.88,4.11%,2.20%,4.05%
2021,Brighton and Hove,E06000043,1496,65,61,60,186,1682,11%,0.94,3.86%,3.63%,3.57%
2021,Milton Keynes,E06000042,3223,131,113,149,393,3616,11%,0.92,3.62%,3.13%,4.12%
2021,Wokingham,E06000041,1601,66,42,65,173,1774,10%,0.83,3.72%,2.37%,3.66%
2021,Windsor and Maidenhead,E06000040,1675,85,57,57,199,1874,11%,0.9,4.54%,3.04%,3.04%
2021,Slough,E06000039,8283,386,260,376,1022,9305,11%,0.93,4.15%,2.79%,4.04%
2021,Reading,E06000038,2980,96,93,119,308,3288,9%,0.8,2.92%,2.83%,3.62%
2021,West Berkshire,E06000037,427,24,13,16,53,480,11%,0.94,5.00%,2.71%,3.33%
2021,Bracknell Forest,E06000036,663,21,21,20,62,725,9%,0.73,2.90%,2.90%,2.76%
2021,Medway,E06000035,1937,95,74,78,247,2184,11%,0.96,4.35%,3.39%,3.57%
2021,Westminster,E09000033,4236,194,166,223,583,4819,12%,1.03,4.03%,3.44%,4.63%
2021,Wandsworth,E09000032,5060,287,211,247,745,5805,13%,1.09,4.94%,3.63%,4.25%
2021,Waltham Forest,E09000031,8213,409,366,485,1260,9473,13%,1.13,4.32%,3.86%,5.12%
2021,Tower Hamlets,E09000030,20228,879,925,1239,3043,23271,13%,1.11,3.78%,3.97%,5.32%
2021,Sutton,E09000029,3408,204,97,148,449,3857,12%,0.99,5.29%,2.51%,3.84%
2021,Southwark,E09000028,3611,160,125,190,475,4086,12%,0.99,3.92%,3.06%,4.65%
2021,Richmond upon Thames,E09000027,1849,103,62,96,261,2110,12%,1.05,4.88%,2.94%,4.55%
2021,Redbridge,E09000026,17481,929,627,842,2398,19879,12%,1.02,4.67%,3.15%,4.24%
2021,Newham,E09000025,20953,892,847,1136,2875,23828,12%,1.02,3.74%,3.55%,4.77%
2021,Merton,E09000024,4848,257,173,268,698,5546,13%,1.07,4.63%,3.12%,4.83%
2021,Lewisham,E09000023,3456,149,105,118,372,3828,10%,0.83,3.89%,2.74%,3.08%
2021,Lambeth,E09000022,3310,172,136,150,458,3768,12%,1.03,4.56%,3.61%,3.98%
2021,Kingston upon Thames,E09000021,3347,170,103,140,413,3760,11%,0.93,4.52%,2.74%,3.72%
2021,Kensington and Chelsea,E09000020,1950,99,54,84,237,2187,11%,0.92,4.53%,2.47%,3.84%
2021,Islington,E09000019,2924,157,116,155,428,3352,13%,1.08,4.68%,3.46%,4.62%
2021,Hounslow,E09000018,12896,593,460,612,1665,14561,11%,0.97,4.07%,3.16%,4.20%
2021,Hillingdon,E09000017,10758,520,361,506,1387,12145,11%,0.97,4.28%,2.97%,4.17%
2021,Havering,E09000016,2752,132,94,119,345,3097,11%,0.95,4.26%,3.04%,3.84%
2021,Harrow,E09000015,14326,950,510,750,2210,16536,13%,1.13,5.75%,3.08%,4.54%
2021,Haringey,E09000014,3865,184,164,205,553,4418,13%,1.06,4.16%,3.71%,4.64%
2021,Hammersmith and Fulham,E09000013,2147,96,84,78,258,2405,11%,0.91,3.99%,3.49%,3.24%
2021,Hackney,E09000012,4282,186,190,297,673,4955,14%,1.15,3.75%,3.83%,5.99%
2021,Greenwich,E09000011,4844,232,156,225,613,5457,11%,0.95,4.25%,2.86%,4.12%
2021,Enfield,E09000010,5499,325,210,331,866,6365,14%,1.16,5.11%,3.30%,5.20%
2021,Ealing,E09000009,15397,734,583,785,2102,17499,12%,1.02,4.19%,3.33%,4.49%
2021,Croydon,E09000008,8524,469,342,445,1256,9780,13%,1.09,4.80%,3.50%,4.55%
2021,Camden,E09000007,5092,259,221,328,808,5900,14%,1.16,4.39%,3.75%,5.56%
2021,Bromley,E09000006,2372,127,57,92,276,2648,10%,0.88,4.80%,2.15%,3.47%
2021,Brent,E09000005,14964,770,556,784,2110,17074,12%,1.05,4.51%,3.26%,4.59%
2021,Bexley,E09000004,2710,117,72,122,311,3021,10%,0.87,3.87%,2.38%,4.04%
2021,Barnet,E09000003,9898,568,406,533,1507,11405,13%,1.12,4.98%,3.56%,4.67%
2021,Barking and Dagenham,E09000002,6358,254,244,252,750,7108,11%,0.9,3.57%,3.43%,3.55%
2021,City of London,E09000001,113,5,3,7,15,128,12%,0.99,3.91%,2.34%,5.47%
2021,West Suffolk,E07000245,309,15,7,5,27,336,8%,0.68,4.46%,2.08%,1.49%
2021,East Suffolk,E07000244,316,15,8,14,37,353,10%,0.89,4.25%,2.27%,3.97%
2021,Stevenage,E07000243,608,30,31,14,75,683,11%,0.93,4.39%,4.54%,2.05%
2021,East Hertfordshire,E07000242,368,25,14,11,50,418,12%,1.02,5.98%,3.35%,2.63%
2021,Welwyn Hatfield,E07000241,754,49,20,27,96,850,11%,0.96,5.76%,2.35%,3.18%
2021,St Albans,E07000240,1217,51,37,54,142,1359,10%,0.89,3.75%,2.72%,3.97%
2021,Mid Suffolk,E07000203,74,3,1,1,5,79,6%,0.54,3.80%,1.27%,1.27%
2021,Ipswich,E07000202,792,32,30,35,97,889,11%,0.93,3.60%,3.37%,3.94%
2021,Babergh,E07000200,105,1,3,2,6,111,5%,0.46,0.90%,2.70%,1.80%
2021,South Norfolk,E07000149,197,7,8,5,20,217,9%,0.78,3.23%,3.69%,2.30%
2021,Norwich,E07000148,664,30,20,13,63,727,9%,0.74,4.13%,2.75%,1.79%
2021,North Norfolk,E07000147,71,6,0,3,9,80,11%,0.96,7.50%,0.00%,3.75%
2021,King's Lynn and West Norfolk,E07000146,225,9,3,9,21,246,9%,0.72,3.66%,1.22%,3.66%
2021,Great Yarmouth,E07000145,137,7,5,8,20,157,13%,1.08,4.46%,3.18%,5.10%
2021,Broadland,E07000144,180,7,4,4,15,195,8%,0.65,3.59%,2.05%,2.05%
2021,Breckland,E07000143,144,5,6,6,17,161,11%,0.9,3.11%,3.73%,3.73%
2021,Watford,E07000103,2338,117,101,116,334,2672,13%,1.06,4.38%,3.78%,4.34%
2021,Three Rivers,E07000102,1127,89,42,55,186,1313,14%,1.2,6.78%,3.20%,4.19%
2021,North Hertfordshire,E07000099,806,33,24,35,92,898,10%,0.87,3.67%,2.67%,3.90%
2021,Hertsmere,E07000098,1026,92,29,40,161,1187,14%,1.15,7.75%,2.44%,3.37%
2021,Dacorum,E07000096,949,40,30,57,127,1076,12%,1,3.72%,2.79%,5.30%
2021,Broxbourne,E07000095,389,27,15,25,67,456,15%,1.25,5.92%,3.29%,5.48%
2021,Uttlesford,E07000077,151,6,3,1,10,161,6%,0.53,3.73%,1.86%,0.62%
2021,Tendring,E07000076,217,12,8,13,33,250,13%,1.12,4.80%,3.20%,5.20%
2021,Rochford,E07000075,113,11,4,3,18,131,14%,1.17,8.40%,3.05%,2.29%
2021,Maldon,E07000074,97,4,5,4,13,110,12%,1,3.64%,4.55%,3.64%
2021,Harlow,E07000073,600,23,20,24,67,667,10%,0.85,3.45%,3.00%,3.60%
2021,Epping Forest,E07000072,980,62,19,33,114,1094,10%,0.88,5.67%,1.74%,3.02%
2021,Colchester,E07000071,853,27,22,33,82,935,9%,0.74,2.89%,2.35%,3.53%
2021,Chelmsford,E07000070,751,33,19,33,85,836,10%,0.86,3.95%,2.27%,3.95%
2021,Castle Point,E07000069,168,4,3,12,19,187,10%,0.86,2.14%,1.60%,6.42%
2021,Brentwood,E07000068,304,14,9,11,34,338,10%,0.85,4.14%,2.66%,3.25%
2021,Braintree,E07000067,303,12,14,17,43,346,12%,1.06,3.47%,4.05%,4.91%
2021,Basildon,E07000066,725,25,13,25,63,788,8%,0.68,3.17%,1.65%,3.17%
2021,South Cambridgeshire,E07000012,649,22,15,22,59,708,8%,0.71,3.11%,2.12%,3.11%
2021,Huntingdonshire,E07000011,549,23,14,18,55,604,9%,0.77,3.81%,2.32%,2.98%
2021,Fenland,E07000010,182,7,7,14,28,210,13%,1.13,3.33%,3.33%,6.67%
2021,East Cambridgeshire,E07000009,172,12,7,10,29,201,14%,1.22,5.97%,3.48%,4.98%
2021,Cambridge,E07000008,1617,60,30,54,144,1761,8%,0.69,3.41%,1.70%,3.07%
2021,Central Bedfordshire,E06000056,967,58,25,48,131,1098,12%,1.01,5.28%,2.28%,4.37%
2021,Bedford,E06000055,3051,132,167,114,413,3464,12%,1.01,3.81%,4.82%,3.29%
2021,Thurrock,E06000034,1257,46,46,54,146,1403,10%,0.88,3.28%,3.28%,3.85%
2021,Southend-on-Sea,E06000033,1129,43,34,45,122,1251,10%,0.83,3.44%,2.72%,3.60%
2021,Luton,E06000032,10845,460,430,573,1463,12308,12%,1.01,3.74%,3.49%,4.66%
2021,Peterborough,E06000031,3852,155,158,200,513,4365,12%,1,3.55%,3.62%,4.58%
2021,Wolverhampton,E08000031,7695,434,299,389,1122,8817,13%,1.08,4.92%,3.39%,4.41%
2021,Walsall,E08000030,7320,277,320,387,984,8304,12%,1.01,3.34%,3.85%,4.66%
2021,Solihull,E08000029,2206,130,85,97,312,2518,12%,1.05,5.16%,3.38%,3.85%
2021,Sandwell,E08000028,11925,474,464,576,1514,13439,11%,0.96,3.53%,3.45%,4.29%
2021,Dudley,E08000027,3591,139,152,192,483,4074,12%,1.01,3.41%,3.73%,4.71%
2021,Coventry,E08000026,7735,357,286,438,1081,8816,12%,1.04,4.05%,3.24%,4.97%
2021,Birmingham,E08000025,50715,2006,2199,2793,6998,57713,12%,1.03,3.48%,3.81%,4.84%
2021,Wyre Forest,E07000239,212,11,6,11,28,240,12%,0.99,4.58%,2.50%,4.58%
2021,Wychavon,E07000238,150,8,1,6,15,165,9%,0.77,4.85%,0.61%,3.64%
2021,Worcester,E07000237,606,26,27,38,91,697,13%,1.11,3.73%,3.87%,5.45%
2021,Redditch,E07000236,618,36,28,40,104,722,14%,1.22,4.99%,3.88%,5.54%
2021,Malvern Hills,E07000235,94,5,3,5,13,107,12%,1.03,4.67%,2.80%,4.67%
2021,Bromsgrove,E07000234,302,17,12,11,40,342,12%,0.99,4.97%,3.51%,3.22%
2021,Warwick,E07000222,1383,85,46,66,197,1580,12%,1.06,5.38%,2.91%,4.18%
2021,Stratford-on-Avon,E07000221,246,9,6,15,30,276,11%,0.92,3.26%,2.17%,5.43%
2021,Rugby,E07000220,841,57,30,35,122,963,13%,1.08,5.92%,3.12%,3.63%
2021,Nuneaton and Bedworth,E07000219,1352,54,46,65,165,1517,11%,0.92,3.56%,3.03%,4.28%
2021,North Warwickshire,E07000218,87,4,2,2,8,95,8%,0.71,4.21%,2.11%,2.11%
2021,Tamworth,E07000199,128,5,4,7,16,144,11%,0.94,3.47%,2.78%,4.86%
2021,Staffordshire Moorlands,E07000198,63,4,4,5,13,76,17%,1.45,5.26%,5.26%,6.58%
2021,Stafford,E07000197,354,15,8,10,33,387,9%,0.72,3.88%,2.07%,2.58%
2021,South Staffordshire,E07000196,361,21,15,8,44,405,11%,0.92,5.19%,3.70%,1.98%
2021,Newcastle-under-Lyme,E07000195,426,11,14,11,36,462,8%,0.66,2.38%,3.03%,2.38%
2021,Lichfield,E07000194,227,15,7,13,35,262,13%,1.13,5.73%,2.67%,4.96%
2021,East Staffordshire,E07000193,1347,39,46,64,149,1496,10%,0.85,2.61%,3.07%,4.28%
2021,Cannock Chase,E07000192,144,6,5,6,17,161,11%,0.9,3.73%,3.11%,3.73%
2021,Shropshire,E06000051,389,17,14,12,43,432,10%,0.85,3.94%,3.24%,2.78%
2021,Stoke-on-Trent,E06000021,3109,108,132,114,354,3463,10%,0.87,3.12%,3.81%,3.29%
2021,Telford and Wrekin,E06000020,1148,43,39,56,138,1286,11%,0.91,3.34%,3.03%,4.35%
2021,"Herefordshire, County of",E06000019,167,9,6,12,27,194,14%,1.18,4.64%,3.09%,6.19%
2021,Rushcliffe,E07000176,643,38,23,36,97,740,13%,1.11,5.14%,3.11%,4.86%
2021,Newark and Sherwood,E07000175,170,6,4,8,18,188,10%,0.81,3.19%,2.13%,4.26%
2021,Mansfield,E07000174,250,11,12,12,35,285,12%,1.04,3.86%,4.21%,4.21%
2021,Gedling,E07000173,547,36,24,30,90,637,14%,1.2,5.65%,3.77%,4.71%
2021,Broxtowe,E07000172,687,35,23,39,97,784,12%,1.05,4.46%,2.93%,4.97%
2021,Bassetlaw,E07000171,127,9,2,5,16,143,11%,0.95,6.29%,1.40%,3.50%
2021,Ashfield,E07000170,207,12,4,8,24,231,10%,0.88,5.19%,1.73%,3.46%
2021,West Lindsey,E07000142,95,4,0,1,5,100,5%,0.42,4.00%,0.00%,1.00%
2021,South Kesteven,E07000141,243,6,8,9,23,266,9%,0.73,2.26%,3.01%,3.38%
2021,South Holland,E07000140,120,7,4,9,20,140,14%,1.21,5.00%,2.86%,6.43%
2021,North Kesteven,E07000139,91,4,5,7,16,107,15%,1.27,3.74%,4.67%,6.54%
2021,Lincoln,E07000138,302,7,5,7,19,321,6%,0.5,2.18%,1.56%,2.18%
2021,East Lindsey,E07000137,115,6,3,14,23,138,17%,1.42,4.35%,2.17%,10.14%
2021,Boston,E07000136,112,6,5,7,18,130,14%,1.18,4.62%,3.85%,5.38%
2021,Oadby and Wigston,E07000135,1716,120,68,85,273,1989,14%,1.17,6.03%,3.42%,4.27%
2021,North West Leicestershire,E07000134,147,13,2,5,20,167,12%,1.02,7.78%,1.20%,2.99%
2021,Melton,E07000133,74,2,1,5,8,82,10%,0.83,2.44%,1.22%,6.10%
2021,Hinckley and Bosworth,E07000132,374,17,9,13,39,413,9%,0.8,4.12%,2.18%,3.15%
2021,Harborough,E07000131,409,36,19,15,70,479,15%,1.24,7.52%,3.97%,3.13%
2021,Charnwood,E07000130,2575,170,79,141,390,2965,13%,1.12,5.73%,2.66%,4.76%
2021,Blaby,E07000129,1011,69,46,43,158,1169,14%,1.15,5.90%,3.93%,3.68%
2021,South Derbyshire,E07000039,396,24,17,16,57,453,13%,1.07,5.30%,3.75%,3.53%
2021,North East Derbyshire,E07000038,121,6,2,3,11,132,8%,0.71,4.55%,1.52%,2.27%
2021,High Peak,E07000037,87,2,3,8,13,100,13%,1.1,2.00%,3.00%,8.00%
2021,Erewash,E07000036,208,9,5,5,19,227,8%,0.71,3.96%,2.20%,2.20%
2021,Derbyshire Dales,E07000035,64,3,1,4,8,72,11%,0.94,4.17%,1.39%,5.56%
2021,Chesterfield,E07000034,216,9,8,11,28,244,11%,0.97,3.69%,3.28%,4.51%
2021,Bolsover,E07000033,88,3,2,3,8,96,8%,0.71,3.13%,2.08%,3.13%
2021,Amber Valley,E07000032,105,9,5,2,16,121,13%,1.12,7.44%,4.13%,1.65%
2021,West Northamptonshire,E06000062,2436,101,68,127,296,2732,11%,0.92,3.70%,2.49%,4.65%
2021,North Northamptonshire,E06000061,1550,69,57,86,212,1762,12%,1.02,3.92%,3.23%,4.88%
2021,Nottingham,E06000018,5814,243,237,313,793,6607,12%,1.02,3.68%,3.59%,4.74%
2021,Rutland,E06000017,45,3,1,1,5,50,10%,0.85,6.00%,2.00%,2.00%
2021,Leicester,E06000016,21490,947,878,1168,2993,24483,12%,1.04,3.87%,3.59%,4.77%
2021,Derby,E06000015,5414,228,235,244,707,6121,12%,0.98,3.72%,3.84%,3.99%
2021,Wakefield,E08000036,1399,55,53,52,160,1559,10%,0.87,3.53%,3.40%,3.34%
2021,Leeds,E08000035,9244,406,325,460,1191,10435,11%,0.97,3.89%,3.11%,4.41%
2021,Kirklees,E08000034,11780,490,517,606,1613,13393,12%,1.02,3.66%,3.86%,4.52%
2021,Calderdale,E08000033,2988,112,155,137,404,3392,12%,1.01,3.30%,4.57%,4.04%
2021,Bradford,E08000032,25793,946,1233,1394,3573,29366,12%,1.03,3.22%,4.20%,4.75%
2021,Sheffield,E08000019,6764,258,285,347,890,7654,12%,0.99,3.37%,3.72%,4.53%
2021,Rotherham,E08000018,1859,69,95,80,244,2103,12%,0.99,3.28%,4.52%,3.80%
2021,Doncaster,E08000017,1147,39,39,65,143,1290,11%,0.94,3.02%,3.02%,5.04%
2021,Barnsley,E08000016,314,13,5,11,29,343,8%,0.72,3.79%,1.46%,3.21%
2021,North Yorkshire,E06000065,660,32,24,23,79,739,11%,0.91,4.33%,3.25%,3.11%
2021,York,E06000014,552,34,12,20,66,618,11%,0.91,5.50%,1.94%,3.24%
2021,North Lincolnshire,E06000013,670,25,27,23,75,745,10%,0.85,3.36%,3.62%,3.09%
2021,North East Lincolnshire,E06000012,252,7,2,14,23,275,8%,0.71,2.55%,0.73%,5.09%
2021,East Riding of Yorkshire,E06000011,338,18,6,9,33,371,9%,0.76,4.85%,1.62%,2.43%
2021,"Kingston upon Hull, City of",E06000010,814,23,20,22,65,879,7%,0.63,2.62%,2.28%,2.50%
2021,Wirral,E08000015,873,41,20,50,111,984,11%,0.96,4.17%,2.03%,5.08%
2021,Sefton,E08000014,500,33,16,37,86,586,15%,1.25,5.63%,2.73%,6.31%
2021,St. Helens,E08000013,279,18,10,5,33,312,11%,0.9,5.77%,3.21%,1.60%
2021,Liverpool,E08000012,3225,115,87,128,330,3555,9%,0.79,3.23%,2.45%,3.60%
2021,Knowsley,E08000011,221,12,9,9,30,251,12%,1.01,4.78%,3.59%,3.59%
2021,Wigan,E08000010,627,18,20,35,73,700,10%,0.89,2.57%,2.86%,5.00%
2021,Trafford,E08000009,3013,159,106,154,419,3432,12%,1.04,4.63%,3.09%,4.49%
2021,Tameside,E08000008,2924,105,133,138,376,3300,11%,0.97,3.18%,4.03%,4.18%
2021,Stockport,E08000007,2530,141,98,88,327,2857,11%,0.97,4.94%,3.43%,3.08%
2021,Salford,E08000006,1749,77,69,76,222,1971,11%,0.96,3.91%,3.50%,3.86%
2021,Rochdale,E08000005,5896,247,277,322,846,6742,13%,1.07,3.66%,4.11%,4.78%
2021,Oldham,E08000004,8390,293,383,472,1148,9538,12%,1.02,3.07%,4.02%,4.95%
2021,Manchester,E08000003,14516,587,607,693,1887,16403,12%,0.98,3.58%,3.70%,4.22%
2021,Bury,E08000002,2701,110,128,141,379,3080,12%,1.04,3.57%,4.16%,4.58%
2021,Bolton,E08000001,7196,326,309,371,1006,8202,12%,1.04,3.97%,3.77%,4.52%
2021,Wyre,E07000128,114,5,2,4,11,125,9%,0.75,4.00%,1.60%,3.20%
2021,West Lancashire,E07000127,127,2,4,8,14,141,10%,0.84,1.42%,2.84%,5.67%
2021,South Ribble,E07000126,259,14,4,13,31,290,11%,0.91,4.83%,1.38%,4.48%
2021,Rossendale,E07000125,527,21,25,28,74,601,12%,1.05,3.49%,4.16%,4.66%
2021,Ribble Valley,E07000124,121,9,7,7,23,144,16%,1.36,6.25%,4.86%,4.86%
2021,Preston,E07000123,3286,167,144,181,492,3778,13%,1.11,4.42%,3.81%,4.79%
2021,Pendle,E07000122,3335,122,161,148,431,3766,11%,0.97,3.24%,4.28%,3.93%
2021,Lancaster,E07000121,374,16,10,17,43,417,10%,0.88,3.84%,2.40%,4.08%
2021,Hyndburn,E07000120,1722,69,76,102,247,1969,13%,1.07,3.50%,3.86%,5.18%
2021,Fylde,E07000119,108,5,0,7,12,120,10%,0.85,4.17%,0.00%,5.83%
2021,Chorley,E07000118,249,9,16,7,32,281,11%,0.97,3.20%,5.69%,2.49%
2021,Burnley,E07000117,1859,70,107,94,271,2130,13%,1.08,3.29%,5.02%,4.41%
2021,Westmorland and Furness,E06000064,197,12,5,2,19,216,9%,0.75,5.56%,2.31%,0.93%
2021,Cumberland,E06000063,262,8,5,12,25,287,9%,0.74,2.79%,1.74%,4.18%
2021,Cheshire West and Chester,E06000050,638,43,18,18,79,717,11%,0.94,6.00%,2.51%,2.51%
2021,Cheshire East,E06000049,744,38,18,40,96,840,11%,0.97,4.52%,2.14%,4.76%
2021,Blackpool,E06000009,378,12,8,11,31,409,8%,0.64,2.93%,1.96%,2.69%
2021,Blackburn with Darwen,E06000008,7040,281,286,378,945,7985,12%,1,3.52%,3.58%,4.73%
2021,Warrington,E06000007,646,20,19,19,58,704,8%,0.7,2.84%,2.70%,2.70%
2021,Halton,E06000006,155,11,3,7,21,176,12%,1.01,6.25%,1.70%,3.98%
2021,Gateshead,E08000037,571,27,32,40,99,670,15%,1.25,4.03%,4.78%,5.97%
2021,Sunderland,E08000024,778,33,26,39,98,876,11%,0.95,3.77%,2.97%,4.45%
2021,South Tyneside,E08000023,553,29,11,17,57,610,9%,0.79,4.75%,1.80%,2.79%
2021,North Tyneside,E08000022,556,29,13,18,60,616,10%,0.83,4.71%,2.11%,2.92%
2021,Newcastle upon Tyne,E08000021,3729,153,126,168,447,4176,11%,0.91,3.66%,3.02%,4.02%
2021,Northumberland,E06000057,407,17,8,13,38,445,9%,0.73,3.82%,1.80%,2.92%
2021,County Durham,E06000047,718,36,31,35,102,820,12%,1.06,4.39%,3.78%,4.27%
2021,Darlington,E06000005,349,6,16,21,43,392,11%,0.93,1.53%,4.08%,5.36%
2021,Stockton-on-Tees,E06000004,1098,33,44,46,123,1221,10%,0.86,2.70%,3.60%,3.77%
2021,Redcar and Cleveland,E06000003,131,8,10,10,28,159,18%,1.5,5.03%,6.29%,6.29%
2021,Middlesbrough,E06000002,1837,72,72,95,239,2076,12%,0.98,3.47%,3.47%,4.58%
2021,TOTAL,,666266,30190,25576,33186,88952,755218,12%,,,,